   customer_id    | customer_first_name | customer_last_name | customer_preferred_cust_flag 
------------------+---------------------+--------------------+------------------------------
 AAAAAAAAAAAADAAA | Kathryn             | Thompson           | Y
 AAAAAAAAAAAAEAAA | Robert              | Patterson          | N
 AAAAAAAAAAAALAAA | Cathy               | Salinas            | Y
 AAAAAAAAAAABMBAA | Jacqueline          | Carlson            | N
 AAAAAAAAAAACGBAA | Margaret            | Bender             | Y
 AAAAAAAAAAACHBAA | Francis             | Thompson           | Y
 AAAAAAAAAAACIAAA | Evelyn              | Ferris             | Y
 AAAAAAAAAAACJBAA | Kenneth             | Bragg              | N
 AAAAAAAAAAACOBAA | Sandra              | Cowan              | N
 AAAAAAAAAAAEDAAA | Paula               | Ferguson           | N
 AAAAAAAAAAAEEAAA | Richard             | Jolley             | Y
 AAAAAAAAAAAFEBAA | Elizabeth           | Gordon             | Y
 AAAAAAAAAAAFNBAA | Jeanette            | Burnett            | Y
 AAAAAAAAAAAGCBAA | Gregory             | Goodwin            | Y
 AAAAAAAAAAAGJBAA | Allison             | Peebles            | Y
 AAAAAAAAAAAGLAAA | Stephanie           | Allen              | N
 AAAAAAAAAAAGPAAA | Gwendolyn           | Prosser            | N
 AAAAAAAAAAAHDAAA | Joyce               | John               | Y
 AAAAAAAAAAAHGBAA | William             | Hernandez          | N
 AAAAAAAAAAAHJAAA | William             | Heck               | N
 AAAAAAAAAAAIIAAA | Ashley              | Shannon            | Y
 AAAAAAAAAAAIJAAA | Nellie              | Hughes             | N
 AAAAAAAAAAAIMAAA | Barbara             |                    | 
 AAAAAAAAAAAINBAA | Salina              | Harper             | Y
 AAAAAAAAAAAJEBAA | Magdalena           | Steward            | N
 AAAAAAAAAAAJGAAA | Charles             | Green              | Y
 AAAAAAAAAAAJHAAA | Anne                | Chambliss          | N
 AAAAAAAAAAAJJAAA | Kimberly            | Phillips           | Y
 AAAAAAAAAAAJNBAA | William             | Montoya            | N
 AAAAAAAAAAAJOAAA | Stephen             | Smith              | N
 AAAAAAAAAAAKABAA | Carla               | Chase              | N
 AAAAAAAAAAALEBAA | Marie               | Ornelas            | N
 AAAAAAAAAAAMCBAA |                     | Smith              | 
 AAAAAAAAAAAMLBAA | Bennie              | Peters             | N
 AAAAAAAAAAAMMAAA | Thomas              | Hanlon             | N
 AAAAAAAAAAANCAAA | Michael             | Lachance           | N
 AAAAAAAAAAANJBAA | Melvin              | Baird              | N
 AAAAAAAAAAAODBAA | Barbara             | Newby              | Y
 AAAAAAAAAAAOGBAA | Bonnie              | Burge              | Y
 AAAAAAAAAAAOHAAA |                     | Williams           | Y
 AAAAAAAAAAAOKBAA | Tara                | Libby              | N
 AAAAAAAAAAAPPAAA | Arleen              | Wright             | N
 AAAAAAAAAABAFBAA | Susan               | Wood               | N
 AAAAAAAAAABALBAA | Thomas              | Pate               | Y
 AAAAAAAAAABAOBAA | Jose                | Chavez             | Y
 AAAAAAAAAABBDAAA | Barbara             | White              | Y
 AAAAAAAAAABBDBAA | Anthony             | Webb               | Y
 AAAAAAAAAABBEBAA | Michael             | Grossman           | Y
 AAAAAAAAAABBGAAA | Cheryl              | Forest             | Y
 AAAAAAAAAABBHBAA | Wendy               | Guillen            | Y
 AAAAAAAAAABBJBAA | Gerald              | Christenson        | N
 AAAAAAAAAABBMBAA | Larry               | Blair              | Y
 AAAAAAAAAABCCBAA | Emily               | Cole               | Y
 AAAAAAAAAABCDAAA | Jennifer            | Mclaughlin         | Y
 AAAAAAAAAABCIBAA | Lisa                | Luckett            | Y
 AAAAAAAAAABCOAAA | Cheryl              | Green              | Y
 AAAAAAAAAABDCAAA | Deborah             | Miller             | N
 AAAAAAAAAABDKAAA | Lorraine            | Mckinley           | N
 AAAAAAAAAABDOAAA | Charles             | Jackson            | Y
 AAAAAAAAAABEBAAA | Lisa                | Weaver             | Y
 AAAAAAAAAABEEBAA | Mark                |                    | Y
 AAAAAAAAAABEHAAA | Steve               | Pratt              | N
 AAAAAAAAAABEMBAA | Willie              | Echevarria         | N
 AAAAAAAAAABFCAAA | Bennett             | Watson             | N
 AAAAAAAAAABFHAAA | Odessa              | Ring               | N
 AAAAAAAAAABFHBAA | Sherri              | Caballero          | Y
 AAAAAAAAAABGFBAA | Tim                 | Morse              | Y
 AAAAAAAAAABGGAAA | Marcus              | Nelson             | Y
 AAAAAAAAAABGKAAA | Victor              | Robinson           | Y
 AAAAAAAAAABGNBAA | Lino                | Bivens             | N
 AAAAAAAAAABHLAAA | Ruth                | Steward            | Y
 AAAAAAAAAABIIBAA |                     | Thompson           | N
 AAAAAAAAAABILAAA | Alex                | Gonzalez           | N
 AAAAAAAAAABINBAA | Jesus               | Mathis             | Y
 AAAAAAAAAABJBBAA | Alice               | Barton             | Y
 AAAAAAAAAABKCAAA | Amanda              | Bourgeois          | N
 AAAAAAAAAABKJBAA | Monique             | Walters            | Y
 AAAAAAAAAABKMBAA | Velma               | Thompson           | Y
 AAAAAAAAAABLEBAA | Mayra               | Oconner            | N
 AAAAAAAAAABLKBAA | Jessica             | Beaver             | Y
 AAAAAAAAAABMCBAA | Douglas             | Butler             | Y
 AAAAAAAAAABMNAAA | Shellie             | Green              | Y
 AAAAAAAAAABNAAAA | Gary                | Johnson            | Y
 AAAAAAAAAABNHBAA | Brian               | Thurston           | N
 AAAAAAAAAABNNBAA | Herbert             | Watts              | N
 AAAAAAAAAABNPAAA | Dale                | Fulton             | Y
 AAAAAAAAAABOABAA | Robert              | Rankin             | Y
 AAAAAAAAAABOEAAA | Joshua              | Velazquez          | Y
 AAAAAAAAAABOIBAA | Melissa             | Thompson           | N
 AAAAAAAAAABPHBAA | Rebecca             | Coleman            | N
 AAAAAAAAAACABBAA | Timothy             | Gonzalez           | Y
 AAAAAAAAAACAOAAA | Tim                 | Roberson           | N
 AAAAAAAAAACBMBAA | Stephen             | Brown              | N
 AAAAAAAAAACBNAAA | Nestor              | Willoughby         | N
 AAAAAAAAAACCEBAA | Nick                | Swartz             | Y
 AAAAAAAAAACCGAAA | Brian               | Mason              | N
 AAAAAAAAAACCIAAA | Gretchen            | Dellinger          | Y
 AAAAAAAAAACCLBAA | Arnoldo             | Doucette           | N
 AAAAAAAAAACDJBAA | Barbara             | Sanchez            | Y
 AAAAAAAAAACDMBAA | Joseph              | George             | N
(100 rows)

