   customer_id    | customer_first_name | customer_last_name 
------------------+---------------------+--------------------
 AAAAAAAAAAAADAAA | Kathryn             | Thompson
 AAAAAAAAAAAAEAAA | Robert              | Patterson
 AAAAAAAAAAAALAAA | Cathy               | Salinas
 AAAAAAAAAAABMAAA | Darrin              | Williams
 AAAAAAAAAAABMBAA | Jacqueline          | Carlson
 AAAAAAAAAAACBBAA | George              | Beck
 AAAAAAAAAAACGBAA | Margaret            | Bender
 AAAAAAAAAAAEDAAA | Paula               | Ferguson
 AAAAAAAAAAAEEAAA | Richard             | Jolley
 AAAAAAAAAAAFEAAA | Javier              | Jernigan
 AAAAAAAAAAAFEBAA | Elizabeth           | Gordon
 AAAAAAAAAAAFNBAA | Jeanette            | Burnett
 AAAAAAAAAAAGCBAA | Gregory             | Goodwin
 AAAAAAAAAAAGJBAA | Allison             | Peebles
 AAAAAAAAAAAGLAAA | Stephanie           | Allen
 AAAAAAAAAAAGPAAA | Gwendolyn           | Prosser
 AAAAAAAAAAAHDAAA | Joyce               | John
 AAAAAAAAAAAHJAAA | William             | Heck
 AAAAAAAAAAAIIAAA | Ashley              | Shannon
 AAAAAAAAAAAIJAAA | Nellie              | Hughes
 AAAAAAAAAAAIMAAA | Barbara             | 
 AAAAAAAAAAAINBAA | Salina              | Harper
 AAAAAAAAAAAJEBAA | Magdalena           | Steward
 AAAAAAAAAAAJGAAA | Charles             | Green
 AAAAAAAAAAAJHAAA | Anne                | Chambliss
 AAAAAAAAAAAJJAAA | Kimberly            | Phillips
 AAAAAAAAAAAJNBAA | William             | Montoya
 AAAAAAAAAAAJOAAA | Stephen             | Smith
 AAAAAAAAAAAKABAA | Carla               | Chase
 AAAAAAAAAAALCAAA | Jeffrey             | Harrison
 AAAAAAAAAAALCBAA | Beverly             | Medina
 AAAAAAAAAAALEBAA | Marie               | Ornelas
 AAAAAAAAAAAMCBAA |                     | Smith
 AAAAAAAAAAAMMAAA | Thomas              | Hanlon
 AAAAAAAAAAANABAA | Dena                | Cox
 AAAAAAAAAAANCAAA | Michael             | Lachance
 AAAAAAAAAAANJBAA | Melvin              | Baird
 AAAAAAAAAAAODBAA | Barbara             | Newby
 AAAAAAAAAAAOGBAA | Bonnie              | Burge
 AAAAAAAAAAAOHAAA |                     | Williams
 AAAAAAAAAAAOKBAA | Tara                | Libby
 AAAAAAAAAABAFBAA | Susan               | Wood
 AAAAAAAAAABANAAA | Vanessa             | Rubio
 AAAAAAAAAABAOBAA | Jose                | Chavez
 AAAAAAAAAABBDAAA | Barbara             | White
 AAAAAAAAAABBEBAA | Michael             | Grossman
 AAAAAAAAAABBHBAA | Wendy               | Guillen
 AAAAAAAAAABBJBAA | Gerald              | Christenson
 AAAAAAAAAABBLBAA | John                | Dodson
 AAAAAAAAAABBMBAA | Larry               | Blair
 AAAAAAAAAABCCBAA | Emily               | Cole
 AAAAAAAAAABCDAAA | Jennifer            | Mclaughlin
 AAAAAAAAAABCIBAA | Lisa                | Luckett
 AAAAAAAAAABCOAAA | Cheryl              | Green
 AAAAAAAAAABDCAAA | Deborah             | Miller
 AAAAAAAAAABDKAAA | Lorraine            | Mckinley
 AAAAAAAAAABDOAAA | Charles             | Jackson
 AAAAAAAAAABEBAAA | Lisa                | Weaver
 AAAAAAAAAABEEBAA | Mark                | 
 AAAAAAAAAABEHAAA | Steve               | Pratt
 AAAAAAAAAABEMBAA | Willie              | Echevarria
 AAAAAAAAAABEPAAA | Marjorie            | Quinn
 AAAAAAAAAABFCAAA | Bennett             | Watson
 AAAAAAAAAABFHAAA | Odessa              | Ring
 AAAAAAAAAABFHBAA | Sherri              | Caballero
 AAAAAAAAAABGFBAA | Tim                 | Morse
 AAAAAAAAAABGGAAA | Marcus              | Nelson
 AAAAAAAAAABGKAAA | Victor              | Robinson
 AAAAAAAAAABGNBAA | Lino                | Bivens
 AAAAAAAAAABHLAAA | Ruth                | Steward
 AAAAAAAAAABIIBAA |                     | Thompson
 AAAAAAAAAABILAAA | Alex                | Gonzalez
 AAAAAAAAAABINBAA | Jesus               | Mathis
 AAAAAAAAAABJBBAA | Alice               | Barton
 AAAAAAAAAABJMAAA | Amy                 | Brackett
 AAAAAAAAAABJNBAA | David               | Tomlinson
 AAAAAAAAAABKCAAA | Amanda              | Bourgeois
 AAAAAAAAAABKDAAA | Dave                | Francis
 AAAAAAAAAABKFBAA | Megan               | Dykes
 AAAAAAAAAABKJBAA | Monique             | Walters
 AAAAAAAAAABKMBAA | Velma               | Thompson
 AAAAAAAAAABLCAAA |                     | 
 AAAAAAAAAABLEBAA | Mayra               | Oconner
 AAAAAAAAAABLKBAA | Jessica             | Beaver
 AAAAAAAAAABMNAAA | Shellie             | Green
 AAAAAAAAAABNAAAA | Gary                | Johnson
 AAAAAAAAAABNHBAA | Brian               | Thurston
 AAAAAAAAAABNNBAA | Herbert             | Watts
 AAAAAAAAAABNPAAA | Dale                | Fulton
 AAAAAAAAAABOABAA | Robert              | Rankin
 AAAAAAAAAABOCAAA | Jesus               | Taylor
 AAAAAAAAAABOEAAA | Joshua              | Velazquez
 AAAAAAAAAABOIBAA | Melissa             | Thompson
 AAAAAAAAAABPHBAA | Rebecca             | Coleman
 AAAAAAAAAACABBAA | Timothy             | Gonzalez
 AAAAAAAAAACAOAAA | Tim                 | Roberson
 AAAAAAAAAACBMBAA | Stephen             | Brown
 AAAAAAAAAACBNAAA | Nestor              | Willoughby
 AAAAAAAAAACCEBAA | Nick                | Swartz
 AAAAAAAAAACCGAAA | Brian               | Mason
(100 rows)

